"filename", "language", "HTML", "Python", "CSS", "JavaScript", "comment", "blank", "total"
"c:\Users\eymen\Pictures\kvkk\kvkk_envanter\hesap\__init__.py", "Python", 0, 0, 0, 0, 0, 1, 1
"c:\Users\eymen\Pictures\kvkk\kvkk_envanter\hesap\admin.py", "Python", 0, 1, 0, 0, 1, 2, 4
"c:\Users\eymen\Pictures\kvkk\kvkk_envanter\hesap\apps.py", "Python", 0, 4, 0, 0, 0, 3, 7
"c:\Users\eymen\Pictures\kvkk\kvkk_envanter\hesap\migrations\__init__.py", "Python", 0, 0, 0, 0, 0, 1, 1
"c:\Users\eymen\Pictures\kvkk\kvkk_envanter\hesap\models.py", "Python", 0, 1, 0, 0, 1, 2, 4
"c:\Users\eymen\Pictures\kvkk\kvkk_envanter\hesap\static\css\bootstrap.min.css", "CSS", 0, 0, 2, 0, 5, 0, 7
"c:\Users\eymen\Pictures\kvkk\kvkk_envanter\hesap\static\css\select.css", "CSS", 0, 0, 1, 0, 0, 1, 2
"c:\Users\eymen\Pictures\kvkk\kvkk_envanter\hesap\static\css\tum.css", "CSS", 0, 0, 39, 0, 1, 9, 49
"c:\Users\eymen\Pictures\kvkk\kvkk_envanter\hesap\static\js\bootstrap.min.js", "JavaScript", 0, 0, 0, 1, 6, 0, 7
"c:\Users\eymen\Pictures\kvkk\kvkk_envanter\hesap\tests.py", "Python", 0, 1, 0, 0, 1, 2, 4
"c:\Users\eymen\Pictures\kvkk\kvkk_envanter\hesap\urls.py", "Python", 0, 7, 0, 0, 0, 1, 8
"c:\Users\eymen\Pictures\kvkk\kvkk_envanter\hesap\views.py", "Python", 0, 56, 0, 0, 0, 17, 73
"c:\Users\eymen\Pictures\kvkk\kvkk_envanter\kvkk_app\__init__.py", "Python", 0, 0, 0, 0, 0, 1, 1
"c:\Users\eymen\Pictures\kvkk\kvkk_envanter\kvkk_app\admin.py", "Python", 0, 24, 0, 0, 1, 2, 27
"c:\Users\eymen\Pictures\kvkk\kvkk_envanter\kvkk_app\apps.py", "Python", 0, 4, 0, 0, 0, 3, 7
"c:\Users\eymen\Pictures\kvkk\kvkk_envanter\kvkk_app\form2.py", "Python", 0, 7, 0, 0, 0, 1, 8
"c:\Users\eymen\Pictures\kvkk\kvkk_envanter\kvkk_app\forms.py", "Python", 0, 8, 0, 0, 0, 1, 9
"c:\Users\eymen\Pictures\kvkk\kvkk_envanter\kvkk_app\login.py", "Python", 0, 7, 0, 0, 0, 1, 8
"c:\Users\eymen\Pictures\kvkk\kvkk_envanter\kvkk_app\migrations\0001_initial.py", "Python", 0, 176, 0, 0, 1, 7, 184
"c:\Users\eymen\Pictures\kvkk\kvkk_envanter\kvkk_app\migrations\0002_kontrol.py", "Python", 0, 15, 0, 0, 1, 6, 22
"c:\Users\eymen\Pictures\kvkk\kvkk_envanter\kvkk_app\migrations\0003_kayili_kisisel_ver_isl_kisiler_and_more.py", "Python", 0, 29, 0, 0, 1, 6, 36
"c:\Users\eymen\Pictures\kvkk\kvkk_envanter\kvkk_app\migrations\0004_aciklamalar.py", "Python", 0, 15, 0, 0, 1, 6, 22
"c:\Users\eymen\Pictures\kvkk\kvkk_envanter\kvkk_app\migrations\__init__.py", "Python", 0, 0, 0, 0, 0, 1, 1
"c:\Users\eymen\Pictures\kvkk\kvkk_envanter\kvkk_app\models.py", "Python", 0, 108, 0, 0, 2, 37, 147
"c:\Users\eymen\Pictures\kvkk\kvkk_envanter\kvkk_app\static\css\all.min.css", "CSS", 0, 0, 1, 0, 5, 0, 6
"c:\Users\eymen\Pictures\kvkk\kvkk_envanter\kvkk_app\static\css\bootstrap.min.css", "CSS", 0, 0, 2, 0, 5, 0, 7
"c:\Users\eymen\Pictures\kvkk\kvkk_envanter\kvkk_app\static\css\drop_profile_image.css", "CSS", 0, 0, 151, 0, 0, 20, 171
"c:\Users\eymen\Pictures\kvkk\kvkk_envanter\kvkk_app\static\css\select.css", "CSS", 0, 0, 1, 0, 0, 1, 2
"c:\Users\eymen\Pictures\kvkk\kvkk_envanter\kvkk_app\static\css\tum.css", "CSS", 0, 0, 95, 0, 0, 28, 123
"c:\Users\eymen\Pictures\kvkk\kvkk_envanter\kvkk_app\static\js\bootstrap.min.js", "JavaScript", 0, 0, 0, 1, 6, 0, 7
"c:\Users\eymen\Pictures\kvkk\kvkk_envanter\kvkk_app\tests.py", "Python", 0, 1, 0, 0, 1, 2, 4
"c:\Users\eymen\Pictures\kvkk\kvkk_envanter\kvkk_app\urls.py", "Python", 0, 9, 0, 0, 0, 4, 13
"c:\Users\eymen\Pictures\kvkk\kvkk_envanter\kvkk_app\views.py", "Python", 0, 70, 0, 0, 1, 19, 90
"c:\Users\eymen\Pictures\kvkk\kvkk_envanter\kvkk_envanter\__init__.py", "Python", 0, 0, 0, 0, 0, 1, 1
"c:\Users\eymen\Pictures\kvkk\kvkk_envanter\kvkk_envanter\asgi.py", "Python", 0, 4, 0, 0, 8, 5, 17
"c:\Users\eymen\Pictures\kvkk\kvkk_envanter\kvkk_envanter\settings.py", "Python", 0, 67, 0, 0, 27, 32, 126
"c:\Users\eymen\Pictures\kvkk\kvkk_envanter\kvkk_envanter\urls.py", "Python", 0, 7, 0, 0, 15, 2, 24
"c:\Users\eymen\Pictures\kvkk\kvkk_envanter\kvkk_envanter\wsgi.py", "Python", 0, 4, 0, 0, 8, 5, 17
"c:\Users\eymen\Pictures\kvkk\kvkk_envanter\manage.py", "Python", 0, 15, 0, 0, 3, 5, 23
"c:\Users\eymen\Pictures\kvkk\kvkk_envanter\templetes\hesap\base.html", "HTML", 117, 0, 0, 0, 0, 7, 124
"c:\Users\eymen\Pictures\kvkk\kvkk_envanter\templetes\hesap\kayit_ol.html", "HTML", 27, 0, 0, 0, 6, 3, 36
"c:\Users\eymen\Pictures\kvkk\kvkk_envanter\templetes\hesap\login.html", "HTML", 26, 0, 0, 0, 0, 3, 29
"c:\Users\eymen\Pictures\kvkk\kvkk_envanter\templetes\hesap\password_reset.html", "HTML", 11, 0, 0, 0, 1, 1, 13
"c:\Users\eymen\Pictures\kvkk\kvkk_envanter\templetes\hesap\password_reset_complete.html", "HTML", 6, 0, 0, 0, 1, 1, 8
"c:\Users\eymen\Pictures\kvkk\kvkk_envanter\templetes\hesap\password_reset_confirm.html", "HTML", 10, 0, 0, 0, 1, 2, 13
"c:\Users\eymen\Pictures\kvkk\kvkk_envanter\templetes\hesap\password_reset_done.html", "HTML", 10, 0, 0, 0, 1, 1, 12
"c:\Users\eymen\Pictures\kvkk\kvkk_envanter\templetes\kvkk_app\anasayfa.html", "HTML", 4, 0, 0, 0, 0, 1, 5
"c:\Users\eymen\Pictures\kvkk\kvkk_envanter\templetes\kvkk_app\base.html", "HTML", 92, 0, 0, 0, 28, 29, 149
"c:\Users\eymen\Pictures\kvkk\kvkk_envanter\templetes\kvkk_app\envanter.html", "HTML", 227, 0, 0, 0, 0, 60, 287
"c:\Users\eymen\Pictures\kvkk\kvkk_envanter\templetes\kvkk_app\kayitlar.html", "HTML", 116, 0, 0, 0, 113, 6, 235
"c:\Users\eymen\Pictures\kvkk\kvkk_envanter\templetes\kvkk_app\profil.html", "HTML", 54, 0, 0, 0, 0, 3, 57
"c:\Users\eymen\Pictures\kvkk\kvkk_envanter\templetes\kvkk_app\veri_giris.html", "HTML", 307, 0, 0, 0, 11, 73, 391
"Total", "-", 1007, 640, 292, 2, 263, 425, 2629